NO ./texts/4.xpm




F 255,255,255





EA ./texts/1.xpm















C 128,128,255








SO ./texts/6.xpm


















WE ./texts/7.xpm






111111111111111111111111111111111111111111111111111111111111
10E000000000000000000000000000000000000000000000000000000001
111111111111111111111111111111111110111111111111111111111111
111111111111111111111111111111111110111111111111111111111111
111111111111111111111111111111111110111111111111111111111111
111111111111111111111111111111111110111111111111111111111111
111111111111111111111111111111111110111111111111111111111111
111111111111111111111111111111111110111111111111111111111111
111111111111111111111111111111111110111111111111111111111111
111111111111111111111111111111111110111111111111111111111111
111111111111111111111111111111111110111111111111111111111111
111111111111111111111111111111111110111111111111111111111111
111111111111111111111111111111111110111111111111111111111111
111111111111111111111111111111111110111111111111111111111111
111111111111111111111111111111111110111111111111111111111111
100000000000000000000000000000000000000000000000000000000001
100000000000000000000000000000000000000000000000000000000001
100000000000000000000000000000000000000000000000000000000001
100000000000000000000000000000000000000000000000000000000001
100000000000000000000000000000000000000000000000000000000001
100000000000000000000000000000000000000000000000000000000001
100000000000000000000000000000000000000000000000000000000001
100000000000000000000000000000000000000000000000000000000001
100000000000000000000000000000000000000000000000000000000001
100000000000000000000000000000000000000000000000000000000001
100000000000000000000000000000000000000000000000000000000001
100000000000000000000000000000000000000000000000000000000001
100000000000000000000000000000000000000000000000000000000001
100000000000000000000000000000000000000000000000000000000001
100000000000000000000000000000000000000000000000000000000001
100000000000000000000000000000000000000000000000000000000001
100000000000000000000000000000000000000000000000000000000001
100000000000000000000000000000000000000000000000000000000001
111111111111111111111111111111111111111111111111111111111111
