NO ./textures/1.xpm
F 30,30,200
EA ./textures/2.xpm
C 22,189,30
SO ./textures/3.xpm
WE ./textures/4.xpm

        1111111111111111111111111
        100000000110000000000001
        1011000001110000000000001
        1001000000000000000000001
11111111101100001110000000000001
100000000011000001110111111111111
11110111111111011100000010001
11110111111111011101010010001
11000000110101011100000010001
1000N000000000001100000010001
10000000000000001101010010001
110000011101010111110111100111
11110111 1110101 10111110001
11111111 1111111 111111111111